NO ./path_to_the_NO
SO ./path_to_the_SO
WE ./path_to_the_WE
EA ./path_to_the_EA


F 220,100,0
C 225,30,0



1111111111111111111111111
1000E0000011000000000001
1111S1
1111111111111111111111111
